R 640 480

NO textures/wall_1.xpm
SO textures/wall_2.xpm
WE textures/wall_3.xpm
EA textures/wall_4.xpm
S textures/sprite_1.xpm
ST textures/sky_1.xpm
FT textures/floor_1.xpm
F 184,113,39
C 51,198,227
111111111111111111111111
100000000000000000000001
100000020000000000000001
100000020000000000000001
100000020000000000000001
100000022000000000000001
100000022000000000000001
100000020000000000000001
100000020000000000000001
100000020000000000000001
100000020000000000000001
100000020000000000000001
100000000000000000000001
100000000000000000000001
100000000000000000000001
100000000000000000000001
100000000000000000000001
100000000000000000000001
100000000000000000000001
100000000000000000000001
10000000000000N000000001
100000000000000000000001
100000000000000000000001
111111111111111111111111
