R 640 480
NO textures/redbrick.xpm
SO textures/wall_2.xpm
WE textures/wall_3.xpm
EA textures/wall_4.xpm
S textures/sprite_1.xpm
F 184,113,39
C 51,198,227
111111111111111111111111111111
100000000000000000000000000001
10001000000000000000N000000001
100000000000000000000000000001
111111111111111111111111111111
10000000001
10000000001
10000000001
10000000001
11111111111
