R 640 480

NO textures/wall_1.xpm
SO textures/wall_2.xpm
WE textures/wall_3.xpm
EA textures/wall_4.xpm
S textures/sprite_1.xpm
ST textures/sky_1.xpm
FT textures/floor_1.xpm
F 184,113,39
C 51,198,227
11111111111111111111 1111
111111111111111111111111 11
10000000000000000000001
11001000000000N000000011
100010000000000000000001
100010000000000000000001
100010002000000000000001
100010000011101000000001
10001000201 111000000001
100000000011100000001111
100000002000000000001
100000000000000000001111
100000000000000000000001
100000002000000000000001
100000000000001000000001
100000002000000000000001
100000000011111111111111
10000000001
100000000001111111111111
100000000000000000000001
100000000000001000000001
100000000000000000000001
100000000000001000000001
100000000000000000000001
111111111111111111111111
