R 640 480

NO textures/wall_1.xpm
SO textures/wall_2.xpm
WE textures/wall_3.xpm
EA textures/wall_4.xpm
S textures/sprite_1.xpm
ST textures/sky_1.xpm
FT textures/floor_1.xpm
F 184,113,39
C 51,198,227

111111 11111111
 11111111111
111001 101
10N0011101
100011101
100011101
100011101
100011101
100011101
100011101
1111111111
