R 640 480

NO textures/wall_1.xpm
SO textures/wall_2.xpm
WE textures/wall_3.xpm
EA textures/wall_4.xpm
S textures/sprite_1.xpm
ST textures/sky_1.xpm
FT textures/floor_1.xpm
F 184,113,39
C 51,198,227
1
1111111111111111111111
1000000000000000000001
1000000000000000000001
1000000000000000000001
1000000000000000000001
1000000000000000000001
1000000000000000000001
1000000000000000000001
1000000000000000000001
1000000000S00000000001
1111111111111111111111
