R 640 480
NO textures/redbrick.xpm
SO textures/wall_2.xpm
WE textures/wall_3.xpm
EA textures/wall_4.xpm
S textures/sprite_1.xpm
F 184,113,39
C 51,198,227

			1111111111111111111111111111111111111111111111111111111111
1111111111111111111111111111111111111111111111111111111111
1N00000000000000000000000000000000000000000000000000000001
1111111111111111111111111111111111111111111111111111111111
