R 680 480

NO textures/wall_1.xpm
SO textures/wall_2.xpm
WE textures/wall_3.xpm
EA textures/wall_4.xpm
S textures/sprite_1.xpm
F 184,113,39
C 51,198,227
                                         11111
1       1                  111          11000111111111
11111111111111111          101          11000000000001
100000000000000011111111111111111111111111000000000001
102000002000002000000000000000000000000000000000000001
100000N00000000011111110111111111111111111110111111111
10002000200020001     101                  101
1000000000000000111111101111111111111111111101
1000200020020000000000000000000000000000000001
1000000000000000111111111111111111111111111111
11111111111111111


